share.sharefeed	分享	1
share.share	分享旧	1
favorite.add	收藏	1
favorite.addrecipe	收藏菜谱	1
digg.digg	赞成果照	1
favorite.getcollectlist	获取收藏列表
favorite.renamemyalbum	重命名收藏文件夹	1
favorite.addmyalbum	添加收藏文件夹	1
favorite.del	删除收藏	1
info.saveinfo	保存菜谱草稿	1
notice.getusernotice	读取通知
message.getmessagelist	读取消息
message.clearonemessagelist	清除一条消息
recipeuser.getfriendlist	获取朋友列表
account.checkin	签到
recipeuser.getuserbyname	搜索豆友
recipeuser.follow	关注
recipeuser.unfollow	取消关注
recipeuser.recuser	recipeuser.recuser
recipeuser.getfans	获取粉丝
recipeuser.checkin	签到

recipeUser.getme
#account.getusersyncinfo


#发布资源
recipephoto.upload	发布成果照	2
info.uploadphoto	上传菜谱照片	2
info.updateandpublic	发布菜谱	3
comment.addcomment	发表评论	2



